111111111111111111111
100000000C0000CC00C01
101C010100100E0010101
1010C1001010101000101
1P0000C00C00C00C000C1
111111111111111111111