1111111111111
1CC1C00C000C1
1C0001C0000C1
1C00C11111001
1P0011E0C0011
1111111111111